111111111111111111111111111
111111111000000100010001001
100000001000000100010001001
111110001000000100010001001
100001001000000100010001001
1110000000000S0000000100001
111111111000000000000100001
100000111111111110000100001
100000000000000000000000101
111111111111111111111111111