NO mk1.png
SO mk2.png
WE mk3.png
EA mk4.png

C 92,7,7
F 33,31,31


111111111111
100000000001
100000000001
100001S10001
100000000001
100000000001
111111111111
