NO walls_images/wall1.png
SO walls_images/wall2.png
WE walls_images/wall3.png
EA walls_images/wall4.png

C 8,8,8
F 92,7,7

11111111111111111111111111111111111111111111111111111111111
10000001000000000100000010000000001000000100000000010000001
10000001000000000100000010000000001000000100000000010000001
10000001000000000100000010000000001000000100000000010000001
10000001000000000100000010000000001000000100000000010000001
10000001110000011100000011100000111000000111000001110000001
100000000011D1100000000000011D1100000000000011D110000000001
11000000000000000000000000000000000000000000000000000000011
10100000000000000000000000000000000000000000000000000000101
10011000000000000000000000000000000000000000000000000011001
1000D00000000000000000000000N000000000000000000000000D0001
100110000000000000000000000000000000000000000000000000011001
10100000000000000000000000000000000000000000000000000000101
11000000000000000000000000000000000000000000000000000000011
100000000011D1100000000000011D1100000000000011D110000000001
10000001110000011100000011100000111000000111000001110000001
10000001000000000100000010000000001000000100000000010000001
10000001000000000100000010000000001000000100000000010000001
10000001000000000100000010000000001000000100000000010000001
10000001000000000100000010000000001000000100000000010000001
11111111111111111111111111111111111111111111111111111111111
