NO walls_images/wall1.png
SO walls_images/wall2.png
WE walls_images/wall3.png
EA walls_images/wall4.png

C 8,8,8
F 92,7,7


111111111110
100000000000
10000W000001
100000000001
111111111111