NO wall1.png
SO wall2.png
WE wall3.png
EA wall4.png

C 8,8,8
F 92,7,7


11111111111111111111111111111111111111111111111111111111111
10000001000000000100000010000000001000000100000000010000001
10000001000000000100000010000000001000000100000000010000001
10000001000000000100000010000000001000000100000000010000001
10000001000000000100000010000000001000000100000000010000001
10000001110000011100000011100000111000000111000001110000001
10000000001101100000000000011011000000000000110110000000001
11000000000000000000000000000000000000000000000000000000011
10100000000000000000000000000000000000000000000000000000101
10010000000000000000000000000000000000000000000000000001001
10001000000000000000000000000N00000000000000000000000010001
10010000000000000000000000000000000000000000000000000001001
10100000000000000000000000000000000000000000000000000000101
11000000000000000000000000000000000000000000000000000000001
10000000001101100000000000011011000000000000110110000000001
10000001110000011100000011100000111000000111000001110000001
10000001000000000100000010000000001000000100000000010000001
10000001000000000100000010000000001000000100000000010000001
10000001000000000100000010000000001000000100000000010000001
10000001000000000100000010000000001000000100000000010000001
11111111111111111111111111111111111111111111111111111111111
